WWWWWWWWWW
W        W
W  C b C W
W  HHHHH W
W  A WXXXW
W     S
W     A  W
W R  HHH W
W  BY T  W
WWWWWWWWWW