WWWWWWWWWW
W    C   W
W  HHHH  W
W        W
W  B WXXXW
W     
W  S  A  W
W    HHH W
W  T     W
WWWWWWWWWW