WWWWWWWWWW
W        W
W  C b C W
W  HHHHH W
W  B WXXXW
W     
W  S  A  W
W    HHH W
W  T     W
WWWWWWWWWW