WWWWWWWWWW
W    C   W
W  HH    W
W        W
W    WXXXW
W      A W
W  S     
W     B  W
W  T     W
WWWWWWWWWW