WWWWWWWWWW
W        W
W  C b C W
W  HHHHHCW
W  A WXXXW
WB    S   
W     A  W
W R  HHH W
Wb AY T  W
WWWWWWWWWW
