WWWWWWWWWW
W    C    W
W  HHHH  W
W        W
W  B WHHHW
W     
W  S  A  W
W    HHH W
W  T     W
WWWWWWWWWW