WWWWWWWWWW
W    C   W
W  HH    W
W        W
W  B WXXXW
W      A W
W  S     W
W        W
W  T     W
WWWWWWWWWW