WWWWWWWWWW
W        W
W  C b C W
W  HHHHH W
W  A WXXXW
W  A  S
W     A  W
W    HHH W
W  B  T  W
WWWWWWWWWW